14 16
1 1 1 1 1 1 1 1 1 1 1 1 1 1 1 1
1 9 9 9 9 9 9 9 9 9 9 9 9 9 9 1
1 9 1 1 1 1 1 1 1 1 1 1 1 1 9 1
1 9 1 9 9 9 9 9 9 9 9 9 9 1 9 1
1 9 1 9 1 1 1 9 9 1 1 1 9 1 9 1
1 9 1 9 1 9 9 9 9 9 9 1 9 1 9 1
1 9 1 9 1 9 9 9 9 9 9 1 9 1 9 1
1 9 1 9 1 9 9 5 6 9 9 1 9 1 9 1
1 9 1 9 1 9 9 7 8 9 9 1 9 1 9 1
1 9 1 9 1 1 1 9 9 1 1 1 9 1 9 1
1 9 1 9 9 9 9 9 9 9 9 9 9 1 9 1
1 9 1 1 1 1 1 1 1 1 1 1 1 1 9 1
1 9 9 9 9 9 9 9 0 9 9 9 9 2 2 1
1 1 1 1 1 1 1 1 1 1 1 1 1 1 1 1